1111111111111111111111111111111111
1111111111111111111111111111111111111111111111111111
111111111111111111111111111111111111111111111111111
11111111111111111111111111111111111111111111
11111111111111111111111111111111111111111111111111
1111111111100100101010101001010100010010101011111111111111111111111
1111111101001001010101000100100000001010111111111
11111111P0000000C00C0000000000000000000C111111111
11111111010010010101010001001000000000000111111111111111
111P0000000C00C000000001001000000100100000000000001111111111111111
11101001001010101000100101001001000000100100111111111111111
1111P0000000C00C000000100100000010010101010000000001111111111111111111111
1111111100000000C00C0000000001001000000000011111111111111111
1111000000001001010101000000001001000001001000101010111111111111111111
111111111100000000000000000000010010011111111111111111
111111111111111111111111111111111111111111111111111
11111111111111111111111111111111111111111111
