1111111111111111111111111111111111
1PE0C0C0C0C0C0C0C0C0C0C0C0C0C0C0C1
1C00000000000000000000000000000001
10000000000000000000000000000000C1
1C00000000000000000000000000000001
10000000000000000000000000000000C1
1C00000000000000000000000000000001
10000000000000000000000000000000C1
1C00000000000000000000000000000001
10000000000000000000000000000000C1
1C00000000000000000000000000000001
10C0C0C0C0C0C0C0C0C0C0C0C0C0C0C0E1
1111111111111111111111111111111111
