111111111
1P01C0C01
110C01001
1000CCE01
111111111


111111111
1ECECECE1
1CCCCCCE1
1ECECECE1
111111111
